13 25
#########################
# p     b   1111 1 1   1#
# # #1# # # # # #1#1# # #
#1  1 11 1 1   1 1 1   1#
#1#1#1# # #1# # #1#1# # #
#1     1 1 1   1   1   1#
# # #1# # # # # #1#1#1# #
# 1b1 11   1111 1 1    1#
# # #1# # # # # #1#1# # #
#1  1 11 1 111 1 1 1   1#
#1#1#1# # #1# # #1#1# # #
#11  111   1 1 1    b   #
#########################