13 25
#########################
#11  111   1 1 1   1  1 #
# # #1# # # # #1#1#1#b# #
# 1 1 11  1 111 1 1    1#
# # #1# # # # # #1#1#1# #
#1  1 11 b 111 1 1 1 1 1#
#1#1#1# #1#1# # #1#1# # #
#1  1 11 b     1 1 1   1#
#1#1#1# # #1# # #1#1# # #
#1p    1 1 1   1   b   1#
# # #1# # # # # #1#1#1# #
#1 1 1   1  1 1  11     #
#########################